Dijun Sha	9SWA	markkelly
Han Lin	10SWA	markparratt
Hanjun Gu	9SWA	markkelly
Hanqin Jiang	8SWA	aarondavies
Hongyu Cao	8SWA	markkelly
Houji Pan	9SWA	markkelly
Huming Liu	10SWA	aarondavies
Jiahui Lu	8SWA	matthewalfonso
Jiaxi Chen	10SWA	matthewalfonso
Jiaying Chen	10SWA	matthewalfonso
Junjia Fan	10SWA	matthewalfonso
Kaiqiu Zhang	8SWA	aarondavies
Lang Lang	10SWA	matthewalfonso
Li Lv	9SWA	scottturner
Lina Jin	10SWA	matthewalfonso
Menglin Gong	10SWA	markkelly
Peifeng Yuan	10SWA	aarondavies
Qiuyi Yu	9SWA	matthewalfonso
Runtian Zhang	8SWA	matthewalfonso
Shenyi Zhang	10SWA	aarondavies
Shuyu Liu	8SWA	aarondavies
Siyuan Liu	10SWA	matthewalfonso
Tianyu Fu	10SWA	matthewalfonso
Wenjing Meng	10SWA	matthewalfonso
Wentao Fan	9SWA	scottturner
Wenyuan Zhou	9SWA	matthewalfonso
Wuming Wang	8SWA	aarondavies
Xiang Fan	8SWA	markkelly
Xinyu Liu	10SWA	matthewalfonso
Xinyue Wang	9SWA	scottturner
Yang Wu	10SWA	aarondavies
Yifan Gu	10SWA	matthewalfonso
Yiran Yang	10SWA	aarondavies
Yufan Yin	9SWA	matthewalfonso
Yuteng Zhao	8SWA	markkelly
Yuxuan Hu	10SWA	markkelly
Yuyin Zhu	8SWA	aarondavies
Zeren Li	9SWA	scottturner
Zeting Zhang	9SWA	scottturner
Zhecheng Jin	10SWA	markparratt
Zhengzhe Wei	10SWA	aarondavies
Zhihao Zhang	10SWA	aarondavies
Zhiyu Jiang	8SWA	aarondavies
Zhongxu Pan	9SWA	markkelly
Zhuang Wei	8SWA	matthewalfonso
Zihan Chen	8SWA	markkelly
Zilai Lu	10SWA	aarondavies
Ziting Chen	10SWA	matthewalfonso
Ziting Sun	9SWA	matthewalfonso
Ziyou Lu	9SWA	markkelly
